1111111111111111111111111
1000000000000000000000001
1000000000000000000000001
1000000000000000000000001
100!000000000000000000001
1000000000000000000000001
1000000000000000000000001
1000000000000000000000001
1000000000000000000000001
1000000000000000000000001
1000001111111111110000001
1000000000000000000000001
1000000000000000000000001
1000000000000000000000001
1000000000000000000000001
1000000000000000000000001
10000000000000000000@0001
1000000000000000000000001
1111111111111111111111111